            111111111111111111111111
        1111100100000001
        111111000N000001
        1111100000000001
        1111100000001001
        1111100000001001
        11111111111111111111111