NO ./textures/north.xpm

SO ./textures/south.xpm

WE ./textures/west.xpm
EA ./textures/east.xpm

F 220, 10,0

C 255  ,   30  ,0


 1111111 11111111
100000101000001
10000111111111111111111111
10000011000000000000010001
10000010000000000000000001
10000011000000000000010001
11101111111011111111110001
110000110000001      10001
100000010000001      10001
100000010000001      10001
10000000000000111111111011111111111
10000001000000100000000000000000001
100000010000001000000000000000000011111
110000110000001000100000000000100010001
111111111111111001000000000000010010001
            10000000000000000000100011
            1000000000000000000010001
            100000000000000000000001
            1000000000000000000010001
            1000000000000000000010001
            10N1000000000000010010001
            1000100000000000100010001
            1000000000000000000010001
            1000000000000000000010001
            1111111111111111111110001
111111111111111111111111111111111111111