NO ./textures/north.xpm

SO ./textures/south.xpm

WE ./textures/west.xpm

EA ./textures/east.xpm

F 220, 100     ,    0

C 255  ,   30  ,0



    11111111111111111111111
        1111 110100011101
        1110101000N010001
        11101100000010001
        11101100010101001
        1111100001011001  
        11111111111111111111111