NO ./textures/north.xpm

SO ./textures/north.xpm

WE ./textures/north.xpm

EA ./textures/north.xpm

F 220, 100     ,    0

C 255  ,   30  ,0



    11111111111111111111111
        1111 110100011101
        11101010000010001
        11101100000010001
        1110110S010101001
        1111100001011001
        11111111111111111111111