NO ./textures/north.xpm

SO ./textures/north.xpm

WE ./textures/north.xpm

EA ./textures/north.xpm

F 220, 100     ,    0

C 255  ,   30  ,0



        11111111111111111111111
        11100000000000001111111
        11100000000000001111111
        11100000N00000001111111
        11100000000000001111111
        11100000000000001111111
        11111111111111111111111