NO ./textures/north.xpm

SO ./textures/south.xpm

WE ./textures/west.xpm
EA ./textures/east.xpm

F 220, 10,0

C 255 ,   30  ,0

1111111
1  1001
1  1001
1  1001
1  1N01
1111111
