            111111111111111111111111
        1111100100000001
        111111000N000001
        1111100000010001
        1111100000101001
        1111100000011001
        11111111111111111111111