NO ./textures/north.xpm

SO ./textures/south.xpm

WE ./textures/west.xpm
EA ./textures/east.xpm

F 220, 10,0

C 255 ,   30  ,0

11111
101 1
111 1
1N1 1
11111